gaˀabi	bigaˀabi	V;PFV
u+siŏba	gúsŏba	V;POT
u+kîʔ	bakîʔ	V;PFV
a+zhuuˀn	ruzhuuˀn	V;HAB
iuˀuyi	riuˀuyi	V;HAB
iun=buaˀa	riun=buaˀa	V;HAB
gaaˀ	gúaˀ	V;POT
shăla	gíshăla	V;POT
bwi	rbwi	V;HAB
iaaˀbi	riaaˀbi	V;HAB
zaka	biaka	V;PFV
asi	gíasi	V;POT
ieˀetu	gíieˀetu	V;POT
uˀuda	gíuˀuda	V;POT
ñiiˀdzhu	biñiiˀdzhu	V;PFV
iuuˀ=stoˀo	biuuˀ=stoˀo	V;PFV
utshi	bitshi	V;PFV
u+g+uuˀyi	gúsuuˀyi	V;POT
bishi	bibishi	V;PFV
u+txîʔtsi	rutxîʔtsi	V;HAB
biˀibí	bibiˀibí	V;PFV
uʔla	rula	V;HAB
txeza	rtxeza	V;HAB
u+sa+gaˀald=yu	gúsa+gaˀald=yu	V;POT
u+txuʔă	gútxuʔă	V;POT
u+s+iăba	rusiăba	V;HAB
dxiˀizi	gudiˀizi	V;PFV
u+z+aˀa	rusaˀa	V;HAB
reˀen=dxesa	rreˀen=dxesa	V;HAB
u+sa+ntxĕ	gúsantxĕ	V;POT
giˀishú	gúˀishú	V;POT
zaˀabi	gízaˀabi	V;POT
u+la	bala	V;PFV
a+dzhĕla	gúdzhĕla	V;POT
u+taʔ	bataʔ	V;PFV
bwidzhi	gúidzhi	V;POT
fiitxi	bifiitxi	V;PFV
u+sa+zhidzí	rusazhidzí	V;HAB
baaˀba	dxîaaˀba	V;POT
sheʔla	gísheʔla	V;POT
u+zoˀoba	ruzoˀoba	V;HAB
u+sa+ñiiˀdzhu	gúsañiiˀdzhu	V;POT
u+txooˀ	gútxooˀ	V;POT
u+s+eˀewu	baseˀewu	V;PFV
gaˀatsi	bigaˀatsi	V;PFV
a+rooˀ	gúrooˀ	V;POT
aaˀyi	riaˀyi	V;HAB
bwĕʔe	biwĕʔe	V;PFV
yasa	ryasa	V;HAB
zhaˀata	baaˀata	V;PFV
u+tyăaˀa	gútyăaˀa	V;POT
gaˀazhu	bigaˀazhu	V;PFV
rooˀ	baoˀ	V;PFV
u+tubí	rutubí	V;HAB
eeˀ	bieˀ	V;PFV
u+sa+zhunga	basazhunga	V;PFV
daˀawu	bidaˀawu	V;PFV
guuˀ	ruuˀ	V;HAB
uˀuyi=dzhiˀidzhi	ruuyi=dzhiˀidzhi	V;HAB
u+shi=rin	rushi=rin	V;HAB
abí	biabí	V;PFV
gaˀatsi	gígaˀatsi	V;POT
ieˀew	gíieˀew	V;POT
u+g+aza	basaza	V;PFV
dzhiˀitshĭ	basˀitshĭ	V;PFV
gaaˀ	baaˀ	V;PFV
a+tasa	gútasa	V;POT
a+dziiˀn	badziiˀn	V;PFV
reˀen=dxesa	bireˀen=dxesa	V;PFV
sheʔla	rsheʔla	V;HAB
u+sa+dzhaga	basadzhaga	V;PFV
îˀi	rîˀi	V;HAB
zhupi	gízhupi	V;POT
dzhishi=zhgasi	basshi=zhgasi	V;PFV
asa	gíasa	V;POT
u+sa+gĭʔi	rusagĭʔi	V;HAB
u+sa+ra	gúsara	V;POT
laʔ	ruʔ	V;HAB
u+sa+g+uaˀa	basaguuaˀa	V;PFV
eeˀ	rieˀ	V;HAB
zhoˀoba	gízhoˀoba	V;POT
tăaˀa	bităaˀa	V;PFV
dxiˀibi	gudiˀibi	V;PFV
dzhuuˀyi	rdzhuuˀyi	V;HAB
ioʔ	bioʔ	V;PFV
u+ga	baga	V;PFV
naˀ aza	gínaˀ aza	V;POT
ñiiˀdzhu	gíñiiˀdzhu	V;POT
u+kăʔa	bakăʔa	V;PFV
txaˀa	rtxaˀa	V;HAB
u+g+aku	gúsaku	V;POT
ziˀi	biziˀi	V;PFV
a	gía	V;POT
dzhishi=zhgasi	russhi=zhgasi	V;HAB
u+su	gúsu	V;POT
reʔ/riaʔ	bireʔ/riaʔ	V;PFV
dusha	rdusha	V;HAB
gaˀabi	bigaˀabi	V;PFV
a+bĭiˀ	rubĭiˀ	V;HAB
ieˀedu	biieˀedu	V;PFV
a+dzhaga	gúdzhaga	V;POT
dxiˀizhu	rdziˀizhu	V;HAB
u+tyăaˀa	batyăaˀa	V;PFV
ropá	bapá	V;PFV
abi	gíabi	V;POT
diăaˀa	rdiăaˀa	V;HAB
uˀun	biˀun	V;PFV
baaˀn	dxîaaˀn	V;POT
gĭʔi	bigĭʔi	V;PFV
ruuˀga	biuuˀga	V;PFV
u+tshăʔa	batshăʔa	V;PFV
u+zeʔ	ruzeʔ	V;HAB
ban	dxîan	V;POT
u+txuʔă	batxuʔă	V;PFV
a	bia	V;PFV
zĭĭn	ruĭn	V;HAB
dxizhi	rdxizhi	V;HAB
ri=gunâʔla	ru=gunâʔla	V;HAB
u+saˀabí	basaˀabí	V;PFV
u+tsiyi	rutsiyi	V;HAB
u+ñiˀibi	ruñiˀibi	V;HAB
a+bwĕʔe	rubwĕʔe	V;HAB
u+răʔa	gúrăʔa	V;POT
iăla	gíiăla	V;POT
u+zhidzí	ruzhidzí	V;HAB
u+g+aza	gúsaza	V;POT
u+lăba	balăba	V;PFV
u+yaˀan	gúyaˀan	V;POT
kayí	bikayí	V;PFV
u+txeldá	gútxeldá	V;POT
iaka	biaka	V;PFV
batxi	dxîatxi	V;POT
uta	bita	V;PFV
shiˀidxi	rshiˀidxi	V;HAB
baˀagú	rbaˀagú	V;HAB
u+shoˀoba	gúshoˀoba	V;POT
a+yidzhi	gúyidzhi	V;POT
bwĕza	rbwĕza	V;HAB
a+tădzhu	rutădzhu	V;HAB
ga	rga	V;HAB
zhiˀin	ruiˀin	V;HAB
guˀudzí	biguˀudzí	V;PFV
tuyí	rtuyí	V;HAB
u+sa+ra	rusara	V;HAB
u+tusha	gútusha	V;POT
gŭʔun	dxîŭʔun	V;POT
u+sa+g+uˀula	basaguuˀula	V;PFV
dxipa	rdzipa	V;HAB
năba	rnăba	V;HAB
u+tshaʔ	gútshaʔ	V;POT
dxiˀida	rdziˀida	V;HAB
tann	dxîann	V;POT
iuyi	biuyi	V;PFV
zĭĭn	baĭn	V;PFV
dxishi	gídxishi	V;POT
a+zhuˀuyi	gúzhuˀuyi	V;POT
u+kaˀabi	gúkaˀabi	V;POT
dxaʔ	bixaʔ	V;PFV
bwîˀi	rbwîˀi	V;HAB
txâˀan	gítxâˀan	V;POT
a+byetxi=garĭ	basetxi=garĭ	V;PFV
a+doˀoba	rudoˀoba	V;HAB
u+g+aku	rusaku	V;HAB
dxîʔyí	bixîʔyí	V;PFV
u+zhuʔn	gíu+zhuʔn	V;POT
ieˀew	biieˀew	V;PFV
u+s+iaʔn	basiaʔn	V;PFV
txaˀa	gítxaˀa	V;POT
u+dziˀiyi	gúdziˀiyi	V;POT
a+tădzhu	batădzhu	V;PFV
iaˀatshu	riaˀatshu	V;HAB
zhuˀubí=dxa	bizhuˀubí=dxa	V;PFV
dusha	gídusha	V;POT
ĭnn	rinn	V;HAB
u+zaʔ	gúzaʔ	V;POT
u+kwiˀidzi	rukwiˀidzi	V;HAB
u+sházhí	basházhí	V;PFV
u+s+iaˀatshu	gúsiaˀatshu	V;POT
zhiˀi=duʔ	gízhiˀi=duʔ	V;POT
u+s+iaˀatshu	rusiaˀatshu	V;HAB
iulda	riulda	V;HAB
dxa	rixa	V;HAB
yaˀa	ryaˀa	V;HAB
u+kâʔ	rukâʔ	V;HAB
a+zaaˀ	gúzaaˀ	V;POT
dalá	balá	V;PFV
a+zaaˀ	bazaaˀ	V;PFV
u+kidzí	bakidzí	V;PFV
u+sa+gaˀald=yu	rusa+gaˀald=yu	V;HAB
yubí	biyubí	V;PFV
u+tusha	batusha	V;PFV
zhiʔ	bizhiʔ	V;PFV
gaˀabi	gígaˀabi	V;POT
iăla	riăla	V;HAB
yiˀibí	ryiˀibí	V;HAB
a+guʔla	gúguʔla	V;POT
tann	biann	V;PFV
u+s+iăba	gúsiăba	V;POT
shiʔ	rshiʔ	V;HAB
uta	rita	V;HAB
dzhagá	bidzhagá	V;PFV
shiˀidxi	gíshiˀidxi	V;POT
nisa	binisa	V;PFV
u+z+uʔyí	gúsuʔyí	V;POT
u+saka=zĭ	gúsaka=zĭ	V;POT
dxiʔtsi	bidxiʔtsi	V;PFV
yaˀa	gíyaˀa	V;POT
a+dziiˀn	rudziiˀn	V;HAB
u+ga	gúga	V;POT
dxishi	rdxishi	V;HAB
zaka=zĭ	baka=zĭ	V;PFV
zhubí=dxa	gízhubí=dxa	V;POT
u+ldâʔ	baldâʔ	V;PFV
zaka	dxîaka	V;POT
a+byetxi=garĭ	gúsetxi=garĭ	V;POT
u+shoˀoba	bashoˀoba	V;PFV
iuʔn	biuʔn	V;PFV
u+tshibi	rutshibi	V;HAB
yaˀa=lo	ruˀa=lo	V;HAB
u+txîʔtsi	batxîʔtsi	V;PFV
yădzhu	biyădzhu	V;PFV
u+sa	gúsa	V;POT
unn	rinn	V;HAB
gooˀba	bigooˀba	V;PFV
u+sa+ldaʔ	basaldaʔ	V;PFV
a+zu	ruzu	V;HAB
u+kîʔ	rukîʔ	V;HAB
taˀa=nĭku	gítaˀa=nĭku	V;POT
